1 5 4 28 0 0 0 0
2 6 5 4 0 1 1 1
3 7 6 5 1 2 2 2
7 6 2 3 3 3 3 3
0 1 5 4 4 4 4 4
6 4 0 1 2 5 5 5
7 5 1 2 3 6 6 6
8 6 2 3 7 7 7 7
6 7 8 8 8 8 8 8
46 47 10 13 12 9 9 9
9 11 14 13 12 10 10 10
10 14 13 11 11 11 11 11
9 10 13 16 15 12 12 12
12 9 10 11 14 17 16 15
13 10 11 17 16 14 14 14
12 13 16 15 15 15 15 15
15 12 13 14 17 16 16 16
16 13 14 17 17 17 17 17
42 19 18 18 18 18 18 18
18 20 22 19 19 19 19 19
19 21 23 22 20 20 20 20
23 22 20 21 21 21 21 21
24 19 20 21 23 25 22 22
25 24 22 20 21 23 23 23
26 22 23 25 27 24 24 24
27 26 24 22 23 25 25 25
24 25 27 26 26 26 26 26
26 24 25 27 27 27 27 27
0 29 34 33 28 28 28 28
28 30 34 33 29 29 29 29
29 31 30 30 30 30 30 30
30 32 35 31 31 31 31 31
31 36 35 32 32 32 32 32
28 29 34 38 37 33 33 33
33 28 29 39 38 37 34 34
31 32 36 41 40 35 35 35
35 32 41 40 36 36 36 36
33 34 38 42 37 37 37 37
27 33 34 39 43 42 38 38
38 34 45 44 43 39 39 39
35 36 41 47 46 45 40 40
40 35 36 47 41 41 41 41
37 38 43 18 42 42 42 42
42 38 39 44 43 43 43 43
43 39 45 46 44 44 44 44
39 40 46 44 45 45 45 45
44 45 40 47 46 46 46 46
46 40 41 47 47 47 47 47
